BaseTestSequence	benchConfig.BaseTestSequence
init	benchConfig.BaseTestSequence
init	benchConfig.BaseTestSequence
start	benchConfig.BaseTestSequence
launchDebugger	benchConfig.BaseTestSequence
restartCsw	benchConfig.BaseTestSequence
end	benchConfig.BaseTestSequence
setInitCswStrategy	benchConfig.BaseTestSequence
isCoverageInstrumented	benchConfig.BaseTestSequence
createLogFile	benchConfig.BaseTestSequence
initGNSSRO	createdpackage.GNSSRO_01
SpyPayload1s	createdpackage.GNSSRO_01
SwitchOnGNSSAndSpy1s	createdpackage.GNSSRO_01
ModifyGNSSforSA1	createdpackage.GNSSRO_01
ModifyGNSSforSA2	createdpackage.GNSSRO_01
SwitchOffGNSSAndSpy1s	createdpackage.GNSSRO_01
initGNSSRO_02	createdpackage.GNSSRO_02
ConfUnitResponses	createdpackage.GNSSRO_02
Modify1553ResponsesSet0	createdpackage.GNSSRO_02
Modify1553ResponsesSet1	createdpackage.GNSSRO_02
